0000011111111111111111100000000000000000000000000000
0000011111111111111111100000000000000000000000000000
0000011111111111111111100000000000000000000000000000
0000011111111111111111100000000000000000000000000000
0000001111111111111111100000000000000000000000000000
0000000000000000011111100000000000000000000000000000
0000000000000000001111100000000000000000000000000000
0001100000000000001111000000000000000000000000000000
0011100000000000001111000000000000000000000000000000
0011100000000000001111000000000000000000000000000000
0011100000000000001111000000000000000000000000000000
0011100000000000001111000000000000000000000000000000
0011100000000000001111000000000000000000000000000000
0011100000000000001111000000000000000000000000000000
0011100000000000001111000000000000000000000000000000
0011100000011111001111111110000000000000000000000000
0011111111111111111111111110000000000000000000000000
0000000000000000000000000000000000000000000000000000
0000000000000000000000000000000000000000000000000000
0000000000000000000000000000000000000000000000000000
