000000010000000000000000000000000000000000
000000000000100000000000000000000000000000
000001010000000000000000000000000000000000
000000001100000000000000000000000000000000
000000111100000000000000000000000000000000
001011000100100000000000000000000000000000
000110111001000000000000000000000000000000
001000100000000000000000000000000000000000
001111111110100000000000000000000000000000
001111101011100000000000000000000000000000
001101111111100000000000000000000000000000
000000000000000000000000000000000000000000
000000000000000000000000000000000000000000
000000000000000000000000000000000000000000
000000000000000000000000000000000000000000
