0000011111111111111111100000000000000000000000000000
0000011111111111111111100000000000000000000000000000
0010111111111111111111100000000000000000000000000000
0101011111111111111111100000000000000000000000000000
1000001111111111111111100000000000000000000000000000
0100000000000000011111100000000000000000000000000000
0000001000101010001111100000000000000000000000000000
0001110010100001001111000000000000000000000000000000
0011101001010010001111000000000000000000000000000000
0011110010100000001111000000000000000000000000000000
0011100000100100001111000000000000000000000000000000
0011110100010001001111000000000000000000000000000000
0011100001000011001111000000000000000000000000000000
0011101010010100001111000000000000000000000000000000
0011100000000000001111000000000000000000000000000000
0011100000011111111111111110000000000000000000000000
0011111111111111111111111110000000000000000000000000
0000000000000000000000000000000000000000000000000000
0000000000000000000000000000000000000000000000000000
0000000000000000000000000000000000000000000000000000
