0000000000000000000000000000000000000000000000000000
0000000000000000000000000000000000000000000000000000
0111100000000000000000000000000000000000000000000000
0111100000000000000000000000000000000000000000000000
1100000000000000000000000000000000000000000000000000
1100010000000000000000000000000000000000000000000000
0000011111111111100000000000000000000000000000000000
0000011111111111100000000000000000000000000000000000
0000011111111111100000000000000000000000000000000000
0000011111111111100000000000000000000000000000000000
0000011111111111100000000000000000000000000000000000
0000011111111111100000000000000000000000000000000000
0000011111111111000000000000000000000000000000000000
0000011111111111100000000000000000000000000000000000
0000011111111111100000000000000000000000000000000000
0000000000000000000000000000000000000000000000000000
0000000000000000000000000000000000000000000000000000
0000000000000000000000000000000000000000000000000000
0000000000000000000000000000000000000000000000000000
0000000000000000000000000000000000000000000000000000
