000000010000000000000000000000000000000000
000000111000000000000000000000000000000000
000001111100000000000000000000000000000000
000011111110000000000000000000000000000000
000111111111000000000000000000000000000000
001111111111100000000000000000000000000000
001111111111100000000000000000000000000000
001111111111100000000000000000000000000000
000000000101000000000000000000000000000000
000001110100000000000000000000000000000000
000010000000000000000000000000000000000000
000000000000000000000000000000000000000000
000000000000000000000000000000000000000000
000000000000000000000000000000000000000000
000000000000000000000000000000000000000000
