1111100000000000000000000010000000000000000000000000
1111100000000000000000000010000000000000000000000000
1111100000000000000000000010000000000000000000000000
1111100000000000000000000010000000000000000000000000
1111110000000000000000000010000000000000000000000000
1111111111111111100000000010000000000000000000000000
1111111111111111100000000010000000000000000000000000
1110011111111111100000000010000000000000000000000000
1100011111111111100000000010000000000000000000000000
1100011111111111100000000010000000000000000000000000
1100011111111111100000000010000000000000000000000000
1100011111111111100000000010000000000000000000000000
1100011111111111100000000010000000000000000000000000
1100011111111111100000000010000000000000000000000000
1100011111111111100000000010000000000000000000000000
1100000000000000000000000000000000000000000000000000
1100000000000000000000000000000000000000000000000000
1111000000000000000000000000000000000000000000000000
1111000000000000000000000000000000000000000000000000
1111000000000000000000000000000000000000000000000000
