111111101111111000000000000000000000000000
111111000111111000100000000000000000000000
111110000011111000000000000000000000000000
111100000001111000000000000000000000000000
111000000000111000000000000000000000000000
110000000000011000000000000000000000000000
110000000000011000000000000000000000000000
110000000000011000100000000000000000000000
110000000000011000000000000000000000000000
110000000000011000000000000000000000000000
110010000000011000000000000000000000000000
111111111111111000000000000000000000000000
111111111111111010000000000000000000000000
111111111111111000000000000000000000000000
111111111111111000000000000000000000000000
