0000000000000000000000011100000000000000000000000000
0000000000000000000000011100000000000000000000000000
0000000000000000000000011100000000000000000000000000
0000000000000000000000011100000000000000000000000000
0000000000000000000000011100000000000000000000000000
0000000000000000000000011100000000000000000000000000
0000000000000000010000011100000000000000000000000000
0000000000000000010000111100000000000000000000000000
0000000000000000010000111100000000000000000000000000
0000000000000000010000111100000000000000000000000000
0000000000000000010000111100000000000000000000000000
0000000000000000010000111100000000000000000000000000
0000000000000000010000111100000000000000000000000000
0000000000000000010000111100000000000000000000000000
0000000000000000010000111100000000000000000000000000
0000011111100000110000000000000000000000000000000000
0000000000000000000000000000000000000000000000000000
0000000000000000000000000000000000000000000000000000
0000000000000000000000000000000000000000000000000000
0000000000000000000000000000000000000000000000000000
