1111100000000000000000000000000000000000000000000000
1111100000000000000000000000000000000000000000000000
0000000000000000000000000000000000000000000000000000
0000000000000000000000000000000000000000000000000000
0000000000000000000000000000000000000000000000000000
0100000000000000000000000000000000000000000000000000
0101100000000000010000000000000000000000000000000000
1110000000000000010000000000000000000000000000000000
1100000000000000010000000000000000000000000000000000
1100000000000000010000000000000000000000000000000000
1100000000000000010000000000000000000000000000000000
1100000000000000010000000000000000000000000000000000
1100000000000000010000000000000000000000000000000000
1100000000000000010000000000000000000000000000000000
1100000000000000010000000000000000000000000000000000
1100011111100000110000000000000000000000000000000000
1100000000000000000000000000000000000000000000000000
1111000000000000000000000000000000000000000000000000
1111000000000000000000000000000000000000000000000000
1111000000000000000000000000000000000000000000000000
