0000000000000000000000000010000000000000000000000000
0000000000000000000000000010000000000000000000000000
0000000000000000000000000010000000000000000000000000
0000000000000000000000000010000000000000000000000000
0001110000000000000000000010000000000000000000000000
0001001111111111100000000010000000000000000000000000
0001000000000000000000000010000000000000000000000000
0110000000000000000000000010000000000000000000000000
0100000000000000000000000010000000000000000000000000
0100000000000000000000000010000000000000000000000000
0100000000000000000000000010000000000000000000000000
0100000000000000000000000010000000000000000000000000
0100000000000000000000000010000000000000000000000000
0100000000000000000000000010000000000000000000000000
0100000000000000000000000010000000000000000000000000
0100011111111111110000000000000000000000000000000000
0100000000000000000000000000000000000000000000000000
0000000000000000000000000000000000000000000000000000
0000000000000000000000000000000000000000000000000000
0000000000000000000000000000000000000000000000000000
